Region 'Agranular insular area' -> 'Agranular insular area' (mapping_type=exact)
Region 'Anterior amygdalar area' -> 'Anterior amygdalar area' (mapping_type=exact)
Region 'Anterior cingulate area' -> 'Anterior cingulate area' (mapping_type=exact)
Region 'Anterior hypothalamic nucleus' -> 'Anterior hypothalamic nucleus' (mapping_type=exact)
Region 'Anterior olfactory nucleus' -> 'Anterior olfactory nucleus' (mapping_type=exact)
Region 'Anterior pretectal nucleus' -> 'Anterior pretectal nucleus' (mapping_type=exact)
Region 'Anterodorsal nucleus' -> 'Anterodorsal nucleus' (mapping_type=exact)
Region 'Anterolateral visual area' -> 'Anterolateral visual area' (mapping_type=exact)
Region 'Anteromedial nucleus' -> 'Anteromedial nucleus' (mapping_type=exact)
Region 'Anteromedial visual area' -> 'Anteromedial visual area' (mapping_type=exact)
Region 'Anteroventral nucleus of thalamus' -> 'Anteroventral nucleus of thalamus' (mapping_type=exact)
Region 'Anteroventral periventricular nucleus' -> 'Anteroventral periventricular nucleus' (mapping_type=exact)
Region 'Anteroventral preoptic nucleus' -> 'Anteroventral preoptic nucleus' (mapping_type=exact)
Region 'Arcuate hypothalamic nucleus' -> 'Arcuate hypothalamic nucleus' (mapping_type=exact)
Region 'Basic cell groups and regions' -> 'Basic cell groups and regions' (mapping_type=exact)
Region 'Basolateral amygdalar nucleus' -> 'Basolateral amygdalar nucleus' (mapping_type=exact)
Region 'Basomedial amygdalar nucleus' -> 'Basomedial amygdalar nucleus' (mapping_type=exact)
Region 'Bed nuclei of the stria terminalis' -> 'Bed nuclei of the stria terminalis' (mapping_type=exact)
Region 'Bed nucleus of the accessory olfactory tract' -> 'Bed nucleus of the accessory olfactory tract' (mapping_type=exact)
Region 'Caudoputamen' -> 'Caudoputamen' (mapping_type=exact)
Region 'Central amygdalar nucleus' -> 'Central amygdalar nucleus' (mapping_type=exact)
Region 'Central lateral nucleus of the thalamus' -> 'Central lateral nucleus of the thalamus' (mapping_type=exact)
Region 'Central medial nucleus of the thalamus' -> 'Central medial nucleus of the thalamus' (mapping_type=exact)
Region 'Cerebral cortex' -> 'Cerebral cortex' (mapping_type=exact)
Region 'Claustrum' -> 'Claustrum' (mapping_type=exact)
Region 'Cortical amygdalar area' -> 'Cortical amygdalar area' (mapping_type=exact)
Region 'Dentate gyrus' -> 'Dentate gyrus' (mapping_type=exact)
Region 'Diagonal band nucleus' -> 'Diagonal band nucleus' (mapping_type=exact)
Region 'Dopaminergic A13 group' -> 'Dopaminergic A13 group' (mapping_type=exact)
Region 'Dorsal auditory area' -> 'Dorsal auditory area' (mapping_type=exact)
Region 'Dorsal part of the lateral geniculate complex' -> 'Dorsal part of the lateral geniculate complex' (mapping_type=exact)
Region 'Dorsal peduncular area' -> 'Dorsal peduncular area' (mapping_type=exact)
Region 'Dorsal premammillary nucleus' -> 'Dorsal premammillary nucleus' (mapping_type=exact)
Region 'Dorsomedial nucleus of the hypothalamus' -> 'Dorsomedial nucleus of the hypothalamus' (mapping_type=exact)
Region 'Ectorhinal area/Layer 1' -> 'Ectorhinal area/Layer 1' (mapping_type=exact)
Region 'Ectorhinal area/Layer 2/3' -> 'Ectorhinal area/Layer 2/3' (mapping_type=exact)
Region 'Ectorhinal area/Layer 5' -> 'Ectorhinal area/Layer 5' (mapping_type=exact)
Region 'Ectorhinal area/Layer 6a' -> 'Ectorhinal area/Layer 6a' (mapping_type=exact)
Region 'Ectorhinal area/Layer 6b' -> 'Ectorhinal area/Layer 6b' (mapping_type=exact)
Region 'Endopiriform nucleus' -> 'Endopiriform nucleus' (mapping_type=exact)
Region 'Entorhinal area' -> 'Entorhinal area' (mapping_type=exact)
Region 'Fasciola cinerea' -> 'Fasciola cinerea' (mapping_type=exact)
Region 'Field CA1' -> 'Field CA1' (mapping_type=exact)
Region 'Field CA2' -> 'Field CA2' (mapping_type=exact)
Region 'Field CA3' -> 'Field CA3' (mapping_type=exact)
Region 'Fundus of striatum' -> 'Fundus of striatum' (mapping_type=exact)
Region 'Globus pallidus' -> 'Globus pallidus, external segment' (mapping_type=override)
Region 'Gustatory areas' -> 'Gustatory areas' (mapping_type=exact)
Region 'Hypothalamus' -> 'Hypothalamus' (mapping_type=exact)
Region 'Induseum griseum' -> 'Induseum griseum' (mapping_type=exact)
Region 'Infralimbic area' -> 'Infralimbic area' (mapping_type=exact)
Region 'Interanterodorsal nucleus of the thalamus' -> 'Interanterodorsal nucleus of the thalamus' (mapping_type=exact)
Region 'Interanteromedial nucleus of the thalamus' -> 'Interanteromedial nucleus of the thalamus' (mapping_type=exact)
Region 'Intercalated amygdalar nucleus' -> 'Intercalated amygdalar nucleus' (mapping_type=exact)
Region 'Intergeniculate leaflet of the lateral geniculate complex' -> 'Intergeniculate leaflet of the lateral geniculate complex' (mapping_type=exact)
Region 'Intermediodorsal nucleus of the thalamus' -> 'Intermediodorsal nucleus of the thalamus' (mapping_type=exact)
Region 'Interpeduncular nucleus' -> 'Interpeduncular nucleus' (mapping_type=exact)
Region 'Islands of Calleja' -> 'Islands of Calleja' (mapping_type=exact)
Region 'Lateral amygdalar nucleus' -> 'Lateral amygdalar nucleus' (mapping_type=exact)
Region 'Lateral dorsal nucleus of thalamus' -> 'Lateral dorsal nucleus of thalamus' (mapping_type=exact)
Region 'Lateral habenula' -> 'Lateral habenula' (mapping_type=exact)
Region 'Lateral hypothalamic area' -> 'Lateral hypothalamic area' (mapping_type=exact)
Region 'Lateral posterior nucleus of the thalamus' -> 'Lateral posterior nucleus of the thalamus' (mapping_type=exact)
Region 'Lateral preoptic area' -> 'Lateral preoptic area' (mapping_type=exact)
Region 'Lateral septal nucleus' -> 'Lateral septal nucleus' (mapping_type=exact)
Region 'Lateral terminal nucleus of the accessory optic tract' -> 'Lateral terminal nucleus of the accessory optic tract' (mapping_type=exact)
Region 'Magnocellular nucleus' -> 'Magnocellular nucleus' (mapping_type=exact)
Region 'Main olfactory bulb' -> 'Main olfactory bulb' (mapping_type=exact)
Region 'Major island of Calleja' -> 'Major island of Calleja' (mapping_type=exact)
Region 'Medial amygdalar nucleus' -> 'Medial amygdalar nucleus' (mapping_type=exact)
Region 'Medial geniculate complex' -> 'Medial geniculate complex' (mapping_type=exact)
Region 'Medial habenula' -> 'Medial habenula' (mapping_type=exact)
Region 'Medial mammillary nucleus' -> 'Medial mammillary nucleus' (mapping_type=exact)
Region 'Medial preoptic area' -> 'Medial preoptic area' (mapping_type=exact)
Region 'Medial preoptic nucleus' -> 'Medial preoptic nucleus' (mapping_type=exact)
Region 'Medial septal nucleus' -> 'Medial septal nucleus' (mapping_type=exact)
Region 'Median preoptic nucleus' -> 'Median preoptic nucleus' (mapping_type=exact)
Region 'Mediodorsal nucleus of the thalamus' -> 'Mediodorsal nucleus of thalamus' (mapping_type=override)
Region 'Midbrain' -> 'Midbrain' (mapping_type=exact)
Region 'Midbrain reticular nucleus' -> 'Midbrain reticular nucleus' (mapping_type=exact)
Region 'Nucleus accumbens' -> 'Nucleus accumbens' (mapping_type=exact)
Region 'Nucleus of reunions' -> 'Nucleus of reuniens' (mapping_type=approx)
Region 'Nucleus of the lateral olfactory tract' -> 'Nucleus of the lateral olfactory tract' (mapping_type=exact)
Region 'Nucleus of the optic tract' -> 'Nucleus of the optic tract' (mapping_type=exact)
Region 'Nucleus of the posterior commissure' -> 'Nucleus of the posterior commissure' (mapping_type=exact)
Region 'Olfactory areas' -> 'Olfactory areas' (mapping_type=exact)
Region 'Olfactory tubercle' -> 'Olfactory tubercle' (mapping_type=exact)
Region 'Olivary pretectal nucleus' -> 'Olivary pretectal nucleus' (mapping_type=exact)
Region 'Orbital area' -> 'Orbital area' (mapping_type=exact)
Region 'Paracentral nucleus' -> 'Paracentral nucleus' (mapping_type=exact)
Region 'Parafascicular nucleus' -> 'Parafascicular nucleus' (mapping_type=exact)
Region 'Parasubthalamic nucleus' -> 'Parasubthalamic nucleus' (mapping_type=exact)
Region 'Parataenial nucleus' -> 'Parataenial nucleus' (mapping_type=exact)
Region 'Paraventricular hypothalamic nucleus' -> 'Paraventricular hypothalamic nucleus' (mapping_type=exact)
Region 'Paraventricular nucleus of the thalamus' -> 'Paraventricular nucleus of the thalamus' (mapping_type=exact)
Region 'Periaqueductal gray' -> 'Periaqueductal gray' (mapping_type=exact)
Region 'Perireunensis nucleus' -> 'Perireunensis nucleus' (mapping_type=exact)
Region 'Perirhinal area' -> 'Perirhinal area' (mapping_type=exact)
Region 'Periventricular hypothalamic nucleus' -> 'Periventricular hypothalamic nucleus, intermediate part' (mapping_type=override)
Region 'Piriform area' -> 'Piriform area' (mapping_type=exact)
Region 'Piriform-amygdalar area' -> 'Piriform-amygdalar area' (mapping_type=exact)
Region 'Posterior amygdalar nucleus' -> 'Posterior amygdalar nucleus' (mapping_type=exact)
Region 'Posterior complex of the thalamus' -> 'Posterior complex of the thalamus' (mapping_type=exact)
Region 'Posterior hypothalamic nucleus' -> 'Posterior hypothalamic nucleus' (mapping_type=exact)
Region 'Posterior limiting nucleus of the thalamus' -> 'Posterior limiting nucleus of the thalamus' (mapping_type=exact)
Region 'Posterior parietal association areas' -> 'Posterior parietal association areas' (mapping_type=exact)
Region 'Postpiriform transition area' -> 'Postpiriform transition area' (mapping_type=exact)
Region 'Precommissural nucleus' -> 'Precommissural nucleus' (mapping_type=exact)
Region 'Prelimbic area' -> 'Prelimbic area' (mapping_type=exact)
Region 'Primary auditory area' -> 'Primary auditory area' (mapping_type=exact)
Region 'Primary motor area' -> 'Primary motor area' (mapping_type=exact)
Region 'Primary somatosensory area' -> 'Primary somatosensory area' (mapping_type=exact)
Region 'Primary visual area' -> 'Primary visual area' (mapping_type=exact)
Region 'Reticular nucleus of the thalamus' -> 'Reticular nucleus of the thalamus' (mapping_type=exact)
Region 'Retrochiasmatic area' -> 'Retrochiasmatic area' (mapping_type=exact)
Region 'Retrosplenial area' -> 'Retrosplenial area' (mapping_type=exact)
Region 'Rhomboid nucleus' -> 'Rhomboid nucleus' (mapping_type=exact)
Region 'Secondary motor area' -> 'Secondary motor area' (mapping_type=exact)
Region 'Septofimbrial nucleus' -> 'Septofimbrial nucleus' (mapping_type=exact)
Region 'Striatum-like amygdalar nuclei' -> 'Striatum-like amygdalar nuclei' (mapping_type=exact)
Region 'Subfornical organ' -> 'Subfornical organ' (mapping_type=exact)
Region 'Subiculum' -> 'Subiculum' (mapping_type=exact)
Region 'Submedial nucleus of the thalamus' -> 'Submedial nucleus of the thalamus' (mapping_type=exact)
Region 'Subparafascicular nucleus' -> 'Subparafascicular nucleus' (mapping_type=exact)
Region 'Subparaventricular zone' -> 'Subparaventricular zone' (mapping_type=exact)
Region 'Substantia innominata' -> 'Substantia innominata' (mapping_type=exact)
Region 'Substantia nigra' -> 'Substantia nigra, compact part' (mapping_type=override)
Region 'Subthalamic nucleus' -> 'Subthalamic nucleus' (mapping_type=exact)
Region 'Superior colliculus' -> 'Superior colliculus, sensory related' (mapping_type=override)
Region 'Supplemental somatosensory area' -> 'Supplemental somatosensory area' (mapping_type=exact)
Region 'Suprageniculate nucleus' -> 'Suprageniculate nucleus' (mapping_type=exact)
Region 'Supramammillary nucleus' -> 'Supramammillary nucleus' (mapping_type=exact)
Region 'Supraoptic nucleus' -> 'Supraoptic nucleus' (mapping_type=exact)
Region 'Taenia tecta' -> 'Taenia tecta' (mapping_type=exact)
Region 'Temporal association areas' -> 'Temporal association areas' (mapping_type=exact)
Region 'Thalamus' -> 'Thalamus' (mapping_type=exact)
Region 'Triangular nucleus of septum' -> 'Triangular nucleus of septum' (mapping_type=exact)
Region 'Tuberal nucleus' -> 'Tuberal nucleus' (mapping_type=exact)
Region 'Ventral anterior-lateral complex of the thalamus' -> 'Ventral anterior-lateral complex of the thalamus' (mapping_type=exact)
Region 'Ventral auditory area' -> 'Ventral auditory area' (mapping_type=exact)
Region 'Ventral medial nucleus of the thalamus' -> 'Ventral medial nucleus of the thalamus' (mapping_type=exact)
Region 'Ventral part of the lateral geniculate complex' -> 'Ventral part of the lateral geniculate complex' (mapping_type=exact)
Region 'Ventral posterolateral nucleus of the thalamus' -> 'Ventral posterolateral nucleus of the thalamus' (mapping_type=exact)
Region 'Ventral posteromedial nucleus of the thalamus' -> 'Ventral posteromedial nucleus of the thalamus' (mapping_type=exact)
Region 'Ventral premammillary nucleus' -> 'Ventral premammillary nucleus' (mapping_type=exact)
Region 'Ventral tegmental area' -> 'Ventral tegmental area' (mapping_type=exact)
Region 'Ventromedial hypothalamic nucleus' -> 'Ventromedial hypothalamic nucleus' (mapping_type=exact)
Region 'Visceral area' -> 'Visceral area' (mapping_type=exact)
Region 'Zona incerta' -> 'Zona incerta' (mapping_type=exact)
